20
20

00000000000000000000
02000000000000000000
00100100100100100100
00000000000000000000
00000000000000000000
00100100100100100100
00000000000000000000
00000000000000000000
00100100100100100100
00000000000000000000
00000000000000000000
00100100100100100100
00000000000000000000
00000000000000000000
00100100100100100100
00000000000000000000
00000000000000000000
00100100100100100100
00000000000000000000
00000000000000000000